Dataset,Classifier,Resampling,Distribution,Threshold,Train_Size,Train_Qt_Class_0,Train_Qt_Class_1,Test_Size,Test_Qt_Class_0,Test_Qt_Class_1,Feature,N_Terms,Tp,Fp,Tn,Fn,Acc_0,Acc_1,Balanced_Acc,Precision,Recall,Fmeasure
Eclipse,knn,bootstrap,balanced,4,5804,2511,3293,1933,836,1097,Description,200,280,308,556,789,0.476190476190476,0.413382899628253,0.444786687909364,0.476190476190476,0.261927034611787,0.337960168980085
Eclipse,knn,bootstrap,balanced,8,5803,3075,2728,1934,1025,909,Description,200,518,485,507,424,0.516450648055833,0.544575725026853,0.530513186541343,0.516450648055833,0.549893842887473,0.532647814910026
Eclipse,knn,bootstrap,balanced,12,5803,3318,2485,1934,1106,828,Description,200,669,470,437,358,0.587357330992098,0.549685534591195,0.568521432791647,0.587357330992098,0.651411879259981,0.617728531855956
Eclipse,knn,bootstrap,balanced,16,5803,3555,2248,1934,1185,749,Description,200,773,468,412,281,0.622884770346495,0.594516594516595,0.608700682431545,0.622884770346495,0.733396584440228,0.67363834422658
Eclipse,knn,bootstrap,balanced,20,5804,3702,2102,1933,1233,700,Description,200,923,510,310,190,0.644103279832519,0.62,0.63205163991626,0.644103279832519,0.829290206648697,0.725058915946583
Eclipse,knn,bootstrap,balanced,24,5804,3861,1943,1933,1286,647,Description,200,989,501,297,146,0.663758389261745,0.670428893905192,0.667093641583469,0.663758389261745,0.87136563876652,0.75352380952381
Eclipse,knn,bootstrap,balanced,28,7630,3977,3653,2542,1325,1217,Description,200,377,146,948,1071,0.720841300191205,0.469539375928678,0.595190338059941,0.720841300191205,0.260359116022099,0.382546930492136
Eclipse,knn,bootstrap,balanced,32,7522,4085,3437,2506,1361,1145,Description,200,444,155,917,990,0.741235392320534,0.480859989512323,0.611047690916429,0.741235392320534,0.309623430962343,0.436792916871618
Eclipse,knn,bootstrap,balanced,64,8185,4612,3573,2728,1537,1191,Description,200,569,119,968,1072,0.82703488372093,0.474509803921569,0.650772343821249,0.82703488372093,0.346739792809263,0.488621726062688
Eclipse,knn,bootstrap,balanced,96,9547,4867,4680,3182,1622,1560,Description,200,511,24,1111,1536,0.955140186915888,0.419720438231961,0.687430312573924,0.955140186915888,0.249633610161212,0.395817195972115
Eclipse,knn,bootstrap,balanced,128,9542,5055,4487,3180,1685,1495,Description,200,621,20,1064,1475,0.968798751950078,0.419062623079953,0.693930687515015,0.968798751950078,0.296278625954198,0.453781512605042
Eclipse,knn,bootstrap,balanced,160,10155,5181,4974,3385,1727,1658,Description,200,702,3,1025,1655,0.995744680851064,0.382462686567164,0.689103683709114,0.995744680851064,0.297836232498939,0.458523840627041
Eclipse,knn,bootstrap,balanced,192,10088,5268,4820,3361,1755,1606,Description,200,774,7,981,1599,0.991037131882202,0.380232558139535,0.685634845010869,0.991037131882202,0.326169405815424,0.490805326569436
Eclipse,knn,bootstrap,balanced,224,10605,5367,5238,3534,1788,1746,Description,200,820,0,968,1746,1,0.356669123065586,0.678334561532793,1,0.319563522992985,0.484347312463083
Eclipse,knn,bootstrap,balanced,256,10669,5429,5240,3555,1809,1746,Description,200,837,0,972,1746,1,0.357615894039735,0.678807947019868,1,0.32404181184669,0.489473684210526
Eclipse,knn,bootstrap,balanced,288,10719,5475,5244,3573,1825,1748,Description,200,901,1,924,1747,0.998891352549889,0.345937850992138,0.672414601771013,0.998891352549889,0.340256797583082,0.507605633802817
Eclipse,knn,bootstrap,balanced,320,10879,5521,5358,3626,1840,1786,Description,200,994,0,846,1786,1,0.321428571428571,0.660714285714286,1,0.357553956834532,0.526762056173821
Eclipse,knn,bootstrap,balanced,352,10919,5571,5348,3638,1856,1782,Description,200,1009,0,847,1782,1,0.322175732217573,0.661087866108787,1,0.361519168756718,0.531052631578947
Eclipse,knn,bootstrap,balanced,384,11088,5607,5481,3696,1869,1827,Description,200,1073,1,796,1826,0.999068901303538,0.303585049580473,0.651326975442006,0.999068901303538,0.370127630217316,0.54014598540146
Eclipse,knn,bootstrap,balanced,416,11179,5635,5544,3726,1878,1848,Description,200,1162,0,716,1848,1,0.279251170046802,0.639625585023401,1,0.386046511627907,0.557046979865772
Eclipse,knn,bootstrap,balanced,448,11264,5667,5597,3753,1888,1865,Description,200,1209,0,679,1865,1,0.26690251572327,0.633451257861635,1,0.393298633702017,0.564557553116974
Eclipse,knn,bootstrap,balanced,480,11323,5683,5640,3774,1894,1880,Description,200,1287,0,607,1880,1,0.244069159630076,0.622034579815038,1,0.40637827597095,0.577907498877414
Eclipse,knn,bootstrap,balanced,512,11342,5697,5645,3779,1898,1881,Description,200,1329,0,569,1881,1,0.232244897959184,0.616122448979592,1,0.414018691588785,0.585591539986781
Eclipse,knn,cv52,balanced,4,5804,2511,3293,1933,836,1097,Description,200,267,329,569,768,0.447986577181208,0.425579655946148,0.436783116563678,0.447986577181208,0.257971014492754,0.327406499080319
Eclipse,knn,cv52,balanced,8,5803,3075,2728,1934,1025,909,Description,200,532,433,493,476,0.551295336787565,0.508771929824561,0.530033633306063,0.551295336787565,0.527777777777778,0.539280283831728
Eclipse,knn,cv52,balanced,12,5803,3318,2485,1934,1106,828,Description,200,678,489,428,339,0.580976863753213,0.558018252933507,0.56949755834336,0.580976863753213,0.666666666666667,0.620879120879121
Eclipse,knn,cv52,balanced,16,5803,3555,2248,1934,1185,749,Description,200,797,497,388,252,0.615919629057187,0.60625,0.611084814528593,0.615919629057187,0.759771210676835,0.680324370465216
Eclipse,knn,cv52,balanced,20,5804,3702,2102,1933,1233,700,Description,200,890,449,343,251,0.664675130694548,0.577441077441077,0.621058104067813,0.664675130694548,0.780017528483786,0.717741935483871
Eclipse,knn,cv52,balanced,24,5804,3861,1943,1933,1286,647,Description,200,1019,499,267,148,0.671277997364954,0.643373493975904,0.657325745670429,0.671277997364954,0.873179091688089,0.75903165735568
Eclipse,knn,cv52,balanced,28,7630,3977,3653,2542,1325,1217,Description,200,401,158,924,1059,0.717352415026834,0.465960665658094,0.591656540342464,0.717352415026834,0.274657534246575,0.397226349678058
Eclipse,knn,cv52,balanced,32,7522,4085,3437,2506,1361,1145,Description,200,464,146,897,999,0.760655737704918,0.473101265822785,0.616878501763851,0.760655737704918,0.317156527682843,0.447660395561987
Eclipse,knn,cv52,balanced,64,8185,4612,3573,2728,1537,1191,Description,200,579,93,958,1098,0.861607142857143,0.465953307392996,0.66378022512507,0.861607142857143,0.34525939177102,0.492975734355045
Eclipse,knn,cv52,balanced,96,9547,4867,4680,3182,1622,1560,Description,200,516,41,1106,1519,0.926391382405745,0.421333333333333,0.673862357869539,0.926391382405745,0.253562653562654,0.398148148148148
Eclipse,knn,cv52,balanced,128,9542,5055,4487,3180,1685,1495,Description,200,615,19,1070,1476,0.970031545741325,0.420267085624509,0.695149315682917,0.970031545741325,0.294117647058824,0.451376146788991
Eclipse,knn,cv52,balanced,160,10155,5181,4974,3385,1727,1658,Description,200,710,5,1017,1653,0.993006993006993,0.380898876404494,0.686952934705744,0.993006993006993,0.300465509944985,0.46133853151397
Eclipse,knn,cv52,balanced,192,10088,5268,4820,3361,1755,1606,Description,200,759,5,996,1601,0.993455497382199,0.383519445514055,0.688487471448127,0.993455497382199,0.321610169491525,0.485915492957746
Eclipse,knn,cv52,balanced,224,10605,5367,5238,3534,1788,1746,Description,200,797,0,991,1746,1,0.362075264888564,0.681037632444282,1,0.313409359024774,0.477245508982036
Eclipse,knn,cv52,balanced,256,10669,5429,5240,3555,1809,1746,Description,200,852,3,957,1743,0.996491228070175,0.354444444444444,0.67546783625731,0.996491228070175,0.328323699421965,0.493913043478261
Eclipse,knn,cv52,balanced,288,10719,5475,5244,3573,1825,1748,Description,200,894,0,931,1748,1,0.347517730496454,0.673758865248227,1,0.338380015140045,0.505656108597285
Eclipse,knn,cv52,balanced,320,10879,5521,5358,3626,1840,1786,Description,200,989,0,851,1786,1,0.322715206674251,0.661357603337126,1,0.356396396396396,0.525504782146653
Eclipse,knn,cv52,balanced,352,10919,5571,5348,3638,1856,1782,Description,200,1006,0,850,1782,1,0.322948328267477,0.661474164133739,1,0.360832137733142,0.530311017395888
Eclipse,knn,cv52,balanced,384,11088,5607,5481,3696,1869,1827,Description,200,1085,0,784,1827,1,0.300268096514745,0.650134048257373,1,0.372596153846154,0.542907180385289
Eclipse,knn,cv52,balanced,416,11179,5635,5544,3726,1878,1848,Description,200,1149,0,729,1848,1,0.282887077997672,0.641443538998836,1,0.383383383383383,0.554269175108538
Eclipse,knn,cv52,balanced,448,11264,5667,5597,3753,1888,1865,Description,200,1208,0,680,1865,1,0.267190569744597,0.633595284872299,1,0.393101204035145,0.564354122868489
Eclipse,knn,cv52,balanced,480,11323,5683,5640,3774,1894,1880,Description,200,1295,0,599,1880,1,0.241629689390883,0.620814844695442,1,0.407874015748032,0.579418344519016
Eclipse,knn,cv52,balanced,512,11342,5697,5645,3779,1898,1881,Description,200,1338,0,560,1881,1,0.22941417451864,0.61470708725932,1,0.415657036346692,0.587228439763002
Eclipse,rf,bootstrap,balanced,4,5804,2511,3293,1933,836,1097,Description,200,255,182,581,915,0.583524027459954,0.388368983957219,0.485946505708587,0.583524027459954,0.217948717948718,0.317361543248289
Eclipse,rf,bootstrap,balanced,8,5803,3075,2728,1934,1025,909,Description,200,669,485,356,424,0.579722703639515,0.456410256410256,0.518066480024886,0.579722703639515,0.612076852698994,0.595460614152203
Eclipse,rf,bootstrap,balanced,12,5803,3318,2485,1934,1106,828,Description,200,951,630,155,198,0.601518026565465,0.439093484419263,0.520305755492364,0.601518026565465,0.827676240208877,0.696703296703297
Eclipse,rf,bootstrap,balanced,16,5803,3555,2248,1934,1185,749,Description,200,1118,687,67,62,0.619390581717452,0.51937984496124,0.569385213339346,0.619390581717452,0.947457627118644,0.749078726968174
Eclipse,rf,bootstrap,balanced,20,5804,3702,2102,1933,1233,700,Description,200,1221,684,12,16,0.640944881889764,0.428571428571429,0.534758155230596,0.640944881889764,0.987065481002425,0.777211966900064
Eclipse,rf,bootstrap,balanced,24,5804,3861,1943,1933,1286,647,Description,200,1280,636,6,11,0.668058455114823,0.352941176470588,0.510499815792705,0.668058455114823,0.99147947327653,0.798253819769255
Eclipse,rf,bootstrap,balanced,28,7630,3977,3653,2542,1325,1217,Description,200,1158,542,167,675,0.681176470588235,0.19833729216152,0.439756881374878,0.681176470588235,0.631751227495908,0.655533540900085
Eclipse,rf,bootstrap,balanced,32,7522,4085,3437,2506,1361,1145,Description,200,1146,419,215,726,0.732268370607029,0.228480340063762,0.480374355335395,0.732268370607029,0.612179487179487,0.666860634274076
Eclipse,rf,bootstrap,balanced,64,8185,4612,3573,2728,1537,1191,Description,200,1368,326,169,865,0.807556080283353,0.163442940038685,0.485499510161019,0.807556080283353,0.612628750559785,0.696715049656226
Eclipse,rf,bootstrap,balanced,96,9547,4867,4680,3182,1622,1560,Description,200,1450,221,172,1339,0.867743865948534,0.113831899404368,0.490787882676451,0.867743865948534,0.519899605593403,0.650224215246637
Eclipse,rf,bootstrap,balanced,128,9542,5055,4487,3180,1685,1495,Description,200,1550,172,135,1323,0.900116144018583,0.092592592592593,0.496354368305588,0.900116144018583,0.539505743125653,0.674646354733406
Eclipse,rf,bootstrap,balanced,160,10155,5181,4974,3385,1727,1658,Description,200,1576,134,151,1524,0.921637426900585,0.090149253731343,0.505893340315964,0.921637426900585,0.508387096774194,0.655301455301455
Eclipse,rf,bootstrap,balanced,192,10088,5268,4820,3361,1755,1606,Description,200,1636,123,119,1483,0.930073905628198,0.074282147315855,0.502178026472026,0.930073905628198,0.524527092016672,0.670766707667077
Eclipse,rf,bootstrap,balanced,224,10605,5367,5238,3534,1788,1746,Description,200,1686,83,102,1663,0.953080836630865,0.057790368271955,0.50543560245141,0.953080836630865,0.503433860853986,0.658851113716295
Eclipse,rf,bootstrap,balanced,256,10669,5429,5240,3555,1809,1746,Description,200,1730,72,79,1674,0.960044395116537,0.045065601825442,0.50255499847099,0.960044395116537,0.508225616921269,0.664617748751441
Eclipse,rf,bootstrap,balanced,288,10719,5475,5244,3573,1825,1748,Description,200,1752,74,73,1674,0.95947426067908,0.041785918717802,0.500630089698441,0.95947426067908,0.51138353765324,0.667174409748667
Eclipse,rf,bootstrap,balanced,320,10879,5521,5358,3626,1840,1786,Description,200,1786,58,54,1728,0.968546637744035,0.03030303030303,0.499424834023532,0.968546637744035,0.508252703471827,0.666666666666667
Eclipse,rf,bootstrap,balanced,352,10919,5571,5348,3638,1856,1782,Description,200,1820,45,36,1737,0.975871313672922,0.020304568527919,0.49808794110042,0.975871313672922,0.511667135226314,0.67133898930284
Eclipse,rf,bootstrap,balanced,384,11088,5607,5481,3696,1869,1827,Description,200,1828,32,41,1795,0.982795698924731,0.022331154684096,0.502563426804414,0.982795698924731,0.504554236820315,0.666788254605143
Eclipse,rf,bootstrap,balanced,416,11179,5635,5544,3726,1878,1848,Description,200,1856,40,22,1808,0.978902953586498,0.012021857923497,0.495462405754998,0.978902953586498,0.506550218340611,0.667625899280576
Eclipse,rf,bootstrap,balanced,448,11264,5667,5597,3753,1888,1865,Description,200,1879,32,9,1833,0.983254840397698,0.004885993485342,0.49407041694152,0.983254840397698,0.506196120689655,0.668326516094611
Eclipse,rf,bootstrap,balanced,480,11323,5683,5640,3774,1894,1880,Description,200,1879,20,15,1860,0.989468141126909,0.008,0.498734070563454,0.989468141126909,0.502540786306499,0.666548421426038
Eclipse,rf,bootstrap,balanced,512,11342,5697,5645,3779,1898,1881,Description,200,1892,27,6,1854,0.985930171964565,0.003225806451613,0.494577989208089,0.985930171964565,0.505072076882008,0.667961165048544
Eclipse,rf,cv52,balanced,4,5804,2511,3293,1933,836,1097,Description,200,241,214,595,883,0.52967032967033,0.402571041948579,0.466120685809454,0.52967032967033,0.2144128113879,0.305256491450285
Eclipse,rf,cv52,balanced,8,5803,3075,2728,1934,1025,909,Description,200,701,515,324,394,0.576480263157895,0.45125348189415,0.513866872526023,0.576480263157895,0.640182648401826,0.606663781912592
Eclipse,rf,cv52,balanced,12,5803,3318,2485,1934,1106,828,Description,200,953,650,153,178,0.59451029320025,0.462235649546828,0.528372971373539,0.59451029320025,0.842617152961981,0.697147037307974
Eclipse,rf,cv52,balanced,16,5803,3555,2248,1934,1185,749,Description,200,1131,699,54,50,0.618032786885246,0.519230769230769,0.568631778058008,0.618032786885246,0.95766299745978,0.751245433410827
Eclipse,rf,cv52,balanced,20,5804,3702,2102,1933,1233,700,Description,200,1213,682,20,18,0.640105540897098,0.526315789473684,0.583210665185391,0.640105540897098,0.985377741673436,0.776071657069738
Eclipse,rf,cv52,balanced,24,5804,3861,1943,1933,1286,647,Description,200,1279,636,7,11,0.667885117493473,0.388888888888889,0.528387003191181,0.667885117493473,0.991472868217054,0.798127925117005
Eclipse,rf,cv52,balanced,28,7630,3977,3653,2542,1325,1217,Description,200,1155,513,170,704,0.692446043165468,0.194508009153318,0.443477026159393,0.692446043165468,0.621301775147929,0.654947547490785
Eclipse,rf,cv52,balanced,32,7522,4085,3437,2506,1361,1145,Description,200,1142,412,219,733,0.734877734877735,0.230042016806723,0.482459875842229,0.734877734877735,0.609066666666667,0.666083406240886
Eclipse,rf,cv52,balanced,64,8185,4612,3573,2728,1537,1191,Description,200,1374,349,163,842,0.797446314567615,0.162189054726368,0.479817684646991,0.797446314567615,0.620036101083033,0.697638994668698
Eclipse,rf,cv52,balanced,96,9547,4867,4680,3182,1622,1560,Description,200,1462,191,160,1369,0.884452510586812,0.104643557880968,0.49454803423389,0.884452510586812,0.516425291416461,0.652096342551293
Eclipse,rf,cv52,balanced,128,9542,5055,4487,3180,1685,1495,Description,200,1568,198,117,1297,0.887882219705549,0.082743988684583,0.485313104195066,0.887882219705549,0.547294938917976,0.677175556035413
Eclipse,rf,cv52,balanced,160,10155,5181,4974,3385,1727,1658,Description,200,1590,121,137,1537,0.929281122150789,0.08183990442055,0.505560513285669,0.929281122150789,0.508474576271186,0.657296403472509
Eclipse,rf,cv52,balanced,192,10088,5268,4820,3361,1755,1606,Description,200,1639,120,116,1486,0.931779420125071,0.072409488139825,0.502094454132448,0.931779420125071,0.52448,0.671171171171171
Eclipse,rf,cv52,balanced,224,10605,5367,5238,3534,1788,1746,Description,200,1674,86,114,1660,0.951136363636364,0.064261555806088,0.507698959721226,0.951136363636364,0.502099580083983,0.657243816254417
Eclipse,rf,cv52,balanced,256,10669,5429,5240,3555,1809,1746,Description,200,1730,75,79,1671,0.958448753462604,0.045142857142857,0.50179580530273,0.958448753462604,0.50867391943546,0.664617748751441
Eclipse,rf,cv52,balanced,288,10719,5475,5244,3573,1825,1748,Description,200,1754,73,71,1675,0.960043787629995,0.040664375715922,0.500354081672958,0.960043787629995,0.511519393409157,0.667427701674277
Eclipse,rf,cv52,balanced,320,10879,5521,5358,3626,1840,1786,Description,200,1782,52,58,1734,0.97164667393675,0.032366071428571,0.502006372682661,0.97164667393675,0.506825938566553,0.666168224299065
Eclipse,rf,cv52,balanced,352,10919,5571,5348,3638,1856,1782,Description,200,1813,46,43,1736,0.975255513717052,0.024170882518269,0.49971319811766,0.975255513717052,0.510848126232742,0.670488165680473
Eclipse,rf,cv52,balanced,384,11088,5607,5481,3696,1869,1827,Description,200,1831,43,38,1784,0.977054429028815,0.020856201975851,0.498955315502333,0.977054429028815,0.506500691562932,0.667152486791765
Eclipse,rf,cv52,balanced,416,11179,5635,5544,3726,1878,1848,Description,200,1854,39,24,1809,0.979397781299525,0.013093289689034,0.496245535494279,0.979397781299525,0.506142506142506,0.667386609071274
Eclipse,rf,cv52,balanced,448,11264,5667,5597,3753,1888,1865,Description,200,1879,24,9,1841,0.987388334209143,0.004864864864865,0.496126599537004,0.987388334209143,0.50510752688172,0.668326516094611
Eclipse,rf,cv52,balanced,480,11323,5683,5640,3774,1894,1880,Description,200,1880,23,14,1857,0.987913820283763,0.007482629609834,0.497698224946798,0.987913820283763,0.503077334760503,0.666666666666667
Eclipse,rf,cv52,balanced,512,11342,5697,5645,3779,1898,1881,Description,200,1891,22,7,1859,0.988499738630423,0.003751339764202,0.496125539197312,0.988499738630423,0.504266666666667,0.667843898993466
Eclipse,svmRadial,bootstrap,balanced,4,5804,2511,3293,1933,836,1097,Description,200,108,98,728,999,0.524271844660194,0.421540243196294,0.472906043928244,0.524271844660194,0.097560975609756,0.164508758568165
Eclipse,svmRadial,bootstrap,balanced,8,5803,3075,2728,1934,1025,909,Description,200,834,653,191,256,0.560860793544048,0.427293064876958,0.494076929210503,0.560860793544048,0.765137614678899,0.647264260768335
Eclipse,svmRadial,bootstrap,balanced,12,5803,3318,2485,1934,1106,828,Description,200,1101,813,5,15,0.575235109717868,0.25,0.412617554858934,0.575235109717868,0.986559139784946,0.726732673267327
Eclipse,svmRadial,bootstrap,balanced,16,5803,3555,2248,1934,1185,749,Description,200,1185,748,0,1,0.613036730470771,0,0.306518365235385,0.613036730470771,0.999156829679595,0.759858929143956
Eclipse,svmRadial,bootstrap,balanced,20,5804,3702,2102,1933,1233,700,Description,200,1233,700,0,0,0.637868598034144,NA,NA,0.637868598034144,1,0.778900821225521
Eclipse,svmRadial,bootstrap,balanced,24,5804,3861,1943,1933,1286,647,Description,200,1286,647,0,0,0.665287118468701,NA,NA,0.665287118468701,1,0.799005902454178
Eclipse,svmRadial,bootstrap,balanced,28,7630,3977,3653,2542,1325,1217,Description,200,829,408,496,809,0.670169765561843,0.38007662835249,0.525123196957167,0.670169765561843,0.506105006105006,0.576695652173913
Eclipse,svmRadial,bootstrap,balanced,32,7522,4085,3437,2506,1361,1145,Description,200,931,433,430,712,0.682551319648094,0.376532399299475,0.529541859473784,0.682551319648094,0.566646378575776,0.619221815763219
Eclipse,svmRadial,bootstrap,balanced,64,8185,4612,3573,2728,1537,1191,Description,200,1183,377,354,814,0.758333333333333,0.303082191780822,0.530707762557078,0.758333333333333,0.592388582874312,0.665167275794209
Eclipse,svmRadial,bootstrap,balanced,96,9547,4867,4680,3182,1622,1560,Description,200,1226,212,396,1348,0.852573018080668,0.227064220183486,0.539818619132077,0.852573018080668,0.476301476301476,0.611166500498505
Eclipse,svmRadial,bootstrap,balanced,128,9542,5055,4487,3180,1685,1495,Description,200,1348,165,337,1330,0.890945142101785,0.202159568086383,0.546552355094084,0.890945142101785,0.50336071695295,0.643283225960391
Eclipse,svmRadial,bootstrap,balanced,160,10155,5181,4974,3385,1727,1658,Description,200,1381,97,346,1561,0.934370771312585,0.181436811746198,0.557903791529391,0.934370771312585,0.469408565601632,0.624886877828054
Eclipse,svmRadial,bootstrap,balanced,192,10088,5268,4820,3361,1755,1606,Description,200,1468,89,287,1517,0.942838792549775,0.159090909090909,0.550964850820342,0.942838792549775,0.49179229480737,0.646411272567151
Eclipse,svmRadial,bootstrap,balanced,224,10605,5367,5238,3534,1788,1746,Description,200,1514,45,274,1701,0.971135343168698,0.13873417721519,0.554934760191944,0.971135343168698,0.470917573872473,0.634268956849602
Eclipse,svmRadial,bootstrap,balanced,256,10669,5429,5240,3555,1809,1746,Description,200,1606,33,203,1713,0.979865771812081,0.105949895615866,0.542907833713973,0.979865771812081,0.483880686953902,0.647841871722469
Eclipse,svmRadial,bootstrap,balanced,288,10719,5475,5244,3573,1825,1748,Description,200,1624,24,201,1724,0.985436893203884,0.104415584415584,0.544926238809734,0.985436893203884,0.485065710872162,0.650120096076861
Eclipse,svmRadial,bootstrap,balanced,320,10879,5521,5358,3626,1840,1786,Description,200,1675,13,165,1773,0.992298578199052,0.085139318885449,0.538718948542251,0.992298578199052,0.485788863109049,0.652258566978193
Eclipse,svmRadial,bootstrap,balanced,352,10919,5571,5348,3638,1856,1782,Description,200,1714,5,142,1777,0.997091332169866,0.073996873371548,0.535544102770707,0.997091332169866,0.490976797479232,0.657965451055662
Eclipse,svmRadial,bootstrap,balanced,384,11088,5607,5481,3696,1869,1827,Description,200,1744,0,125,1827,1,0.064036885245902,0.532018442622951,1,0.488378605432652,0.656255879586077
Eclipse,svmRadial,bootstrap,balanced,416,11179,5635,5544,3726,1878,1848,Description,200,1766,0,112,1848,1,0.057142857142857,0.528571428571429,1,0.488655229662424,0.656505576208179
Eclipse,svmRadial,bootstrap,balanced,448,11264,5667,5597,3753,1888,1865,Description,200,1815,0,73,1865,1,0.037667698658411,0.518833849329205,1,0.49320652173913,0.660600545950864
Eclipse,svmRadial,bootstrap,balanced,480,11323,5683,5640,3774,1894,1880,Description,200,1839,9,55,1871,0.99512987012987,0.028556593977155,0.511843232053512,0.99512987012987,0.495687331536388,0.661748830514574
Eclipse,svmRadial,bootstrap,balanced,512,11342,5697,5645,3779,1898,1881,Description,200,1853,3,45,1878,0.998383620689655,0.023400936037442,0.510892278363548,0.998383620689655,0.496649691771643,0.663325577232862
Eclipse,svmRadial,cv52,balanced,4,5804,2511,3293,1933,836,1097,Description,200,224,165,612,932,0.575835475578406,0.396373056994819,0.486104266286612,0.575835475578406,0.193771626297578,0.289967637540453
Eclipse,svmRadial,cv52,balanced,8,5803,3075,2728,1934,1025,909,Description,200,694,540,331,369,0.562398703403566,0.472857142857143,0.517627923130354,0.562398703403566,0.652869238005644,0.604266434479756
Eclipse,svmRadial,cv52,balanced,12,5803,3318,2485,1934,1106,828,Description,200,1101,814,5,14,0.574934725848564,0.263157894736842,0.419046310292703,0.574934725848564,0.987443946188341,0.726732673267327
Eclipse,svmRadial,cv52,balanced,16,5803,3555,2248,1934,1185,749,Description,200,1182,737,3,12,0.615945805106827,0.2,0.407972902553413,0.615945805106827,0.989949748743719,0.759396080950851
Eclipse,svmRadial,cv52,balanced,20,5804,3702,2102,1933,1233,700,Description,200,1213,676,20,24,0.642138697723663,0.454545454545455,0.548342076134559,0.642138697723663,0.980598221503638,0.776071657069738
Eclipse,svmRadial,cv52,balanced,24,5804,3861,1943,1933,1286,647,Description,200,1286,647,0,0,0.665287118468701,NA,NA,0.665287118468701,1,0.799005902454178
Eclipse,svmRadial,cv52,balanced,28,7630,3977,3653,2542,1325,1217,Description,200,832,378,493,839,0.687603305785124,0.37012012012012,0.528861712952622,0.687603305785124,0.497905445840814,0.577577230128428
Eclipse,svmRadial,cv52,balanced,32,7522,4085,3437,2506,1361,1145,Description,200,940,413,421,732,0.694752402069475,0.365134431916739,0.529943416993107,0.694752402069475,0.562200956937799,0.621487603305785
Eclipse,svmRadial,cv52,balanced,64,8185,4612,3573,2728,1537,1191,Description,200,1196,380,341,811,0.758883248730964,0.296006944444444,0.527445096587704,0.758883248730964,0.595914299950174,0.667596985766118
Eclipse,svmRadial,cv52,balanced,96,9547,4867,4680,3182,1622,1560,Description,200,1222,195,400,1365,0.862385321100917,0.226628895184136,0.544507108142527,0.862385321100917,0.472361809045226,0.61038961038961
Eclipse,svmRadial,cv52,balanced,128,9542,5055,4487,3180,1685,1495,Description,200,1355,163,330,1332,0.89262187088274,0.1985559566787,0.54558891378072,0.89262187088274,0.504279866021585,0.644470868014269
Eclipse,svmRadial,cv52,balanced,160,10155,5181,4974,3385,1727,1658,Description,200,1394,101,333,1557,0.932441471571906,0.176190476190476,0.554315973881191,0.932441471571906,0.472382243307353,0.627080521817364
Eclipse,svmRadial,cv52,balanced,192,10088,5268,4820,3361,1755,1606,Description,200,1448,89,307,1517,0.942094990240729,0.168311403508772,0.55520319687475,0.942094990240729,0.488364249578415,0.643269657929809
Eclipse,svmRadial,cv52,balanced,224,10605,5367,5238,3534,1788,1746,Description,200,1519,45,269,1701,0.971227621483376,0.136548223350254,0.553887922416815,0.971227621483376,0.471739130434783,0.635033444816054
Eclipse,svmRadial,cv52,balanced,256,10669,5429,5240,3555,1809,1746,Description,200,1605,22,204,1724,0.986478180700676,0.105809128630705,0.546143654665691,0.986478180700676,0.482126764794232,0.647699757869249
Eclipse,svmRadial,cv52,balanced,288,10719,5475,5244,3573,1825,1748,Description,200,1625,41,200,1707,0.975390156062425,0.10487676979549,0.540133462928958,0.975390156062425,0.487695078031212,0.650260104041617
Eclipse,svmRadial,cv52,balanced,320,10879,5521,5358,3626,1840,1786,Description,200,1662,10,178,1776,0.994019138755981,0.091095189355169,0.542557164055575,0.994019138755981,0.483420593368237,0.650489236790607
Eclipse,svmRadial,cv52,balanced,352,10919,5571,5348,3638,1856,1782,Description,200,1722,2,134,1780,0.998839907192575,0.070010449320794,0.534425178256685,0.998839907192575,0.491719017704169,0.659012629161883
Eclipse,svmRadial,cv52,balanced,384,11088,5607,5481,3696,1869,1827,Description,200,1744,0,125,1827,1,0.064036885245902,0.532018442622951,1,0.488378605432652,0.656255879586077
Eclipse,svmRadial,cv52,balanced,416,11179,5635,5544,3726,1878,1848,Description,200,1776,0,102,1848,1,0.052307692307692,0.526153846153846,1,0.490066225165563,0.657777777777778
Eclipse,svmRadial,cv52,balanced,448,11264,5667,5597,3753,1888,1865,Description,200,1818,0,70,1865,1,0.036175710594315,0.518087855297158,1,0.49361933206625,0.660970732594074
Eclipse,svmRadial,cv52,balanced,480,11323,5683,5640,3774,1894,1880,Description,200,1831,3,63,1877,0.998364231188659,0.032474226804124,0.515419228996391,0.998364231188659,0.493797195253506,0.660772284373872
Eclipse,svmRadial,cv52,balanced,512,11342,5697,5645,3779,1898,1881,Description,200,1855,8,43,1873,0.995705850778315,0.022442588726514,0.509074219752414,0.995705850778315,0.497585836909871,0.663566446074048
Eclipse,knn,bootstrap,balanced,4,5952,2595,3357,1983,865,1118,Description_Summary,200,275,277,590,841,0.498188405797101,0.412299091544375,0.455243748670738,0.498188405797101,0.246415770609319,0.329736211031175
Eclipse,knn,bootstrap,balanced,8,5952,3174,2778,1983,1058,925,Description_Summary,200,529,419,529,506,0.558016877637131,0.511111111111111,0.534563994374121,0.558016877637131,0.511111111111111,0.533535047907211
Eclipse,knn,bootstrap,balanced,12,5952,3423,2529,1983,1140,843,Description_Summary,200,715,450,425,393,0.613733905579399,0.519559902200489,0.566646903889944,0.613733905579399,0.645306859205776,0.629124505059393
Eclipse,knn,bootstrap,balanced,16,5952,3665,2287,1983,1221,762,Description_Summary,200,828,507,393,255,0.620224719101124,0.606481481481482,0.613353100291303,0.620224719101124,0.764542936288089,0.684863523573201
Eclipse,knn,bootstrap,balanced,20,5952,3812,2140,1983,1270,713,Description_Summary,200,936,505,334,208,0.649548924358085,0.616236162361624,0.632892543359854,0.649548924358085,0.818181818181818,0.724177949709864
Eclipse,knn,bootstrap,balanced,24,7927,3977,3950,2641,1325,1316,Description_Summary,200,338,129,987,1187,0.723768736616702,0.454001839926403,0.588885288271553,0.723768736616702,0.221639344262295,0.339357429718876
Eclipse,knn,bootstrap,balanced,28,7809,4095,3714,2602,1364,1238,Description_Summary,200,340,147,1024,1091,0.698151950718686,0.484160756501182,0.591156353609934,0.698151950718686,0.23759608665269,0.354535974973931
Eclipse,knn,bootstrap,balanced,32,7699,4204,3495,2566,1401,1165,Description_Summary,200,442,139,959,1026,0.760757314974182,0.483123425692695,0.621940370333439,0.760757314974182,0.301089918256131,0.431429965836994
Eclipse,knn,bootstrap,balanced,64,8376,4740,3636,2791,1579,1212,Description_Summary,200,555,105,1024,1107,0.840909090909091,0.480525574847489,0.66071733287829,0.840909090909091,0.333935018050542,0.478036175710594
Eclipse,knn,bootstrap,balanced,96,9765,4998,4767,3254,1666,1588,Description_Summary,200,526,35,1140,1553,0.937611408199644,0.423319717786855,0.680465562993249,0.937611408199644,0.253006253006253,0.398484848484848
Eclipse,knn,bootstrap,balanced,128,9754,5191,4563,3251,1730,1521,Description_Summary,200,620,23,1110,1498,0.964230171073095,0.425613496932515,0.694921834002805,0.964230171073095,0.292728989612842,0.4491126403477
Eclipse,knn,bootstrap,balanced,160,10377,5319,5058,3459,1773,1686,Description_Summary,200,730,9,1043,1677,0.987821380243572,0.383455882352941,0.685638631298257,0.987821380243572,0.303282093892813,0.464081373172282
Eclipse,knn,bootstrap,balanced,192,10314,5406,4908,3437,1802,1635,Description_Summary,200,797,5,1005,1630,0.993765586034913,0.381404174573055,0.687584880303984,0.993765586034913,0.328388957560775,0.493651285227625
Eclipse,knn,bootstrap,balanced,224,10844,5507,5337,3614,1835,1779,Description_Summary,200,871,2,964,1777,0.997709049255441,0.351696461145567,0.674702755200504,0.997709049255441,0.32892749244713,0.494745810849191
Eclipse,knn,bootstrap,balanced,256,10905,5571,5334,3634,1856,1778,Description_Summary,200,893,0,963,1778,1,0.351331630791682,0.675665815395841,1,0.334331710969674,0.501122334455668
Eclipse,knn,bootstrap,balanced,288,10935,5619,5316,3645,1873,1772,Description_Summary,200,934,0,939,1772,1,0.346366654371081,0.67318332718554,1,0.345158906134516,0.513186813186813
Eclipse,knn,bootstrap,balanced,320,11082,5667,5415,3693,1888,1805,Description_Summary,200,979,0,909,1805,1,0.334929992630803,0.667464996315402,1,0.351652298850575,0.520329524315706
Eclipse,knn,bootstrap,balanced,352,11351,5717,5634,3783,1905,1878,Description_Summary,200,1081,0,824,1878,1,0.304959289415248,0.652479644707624,1,0.365326123690436,0.535148514851485
Eclipse,knn,bootstrap,balanced,384,11496,5754,5742,3831,1917,1914,Description_Summary,200,1103,0,814,1914,1,0.298387096774194,0.649193548387097,1,0.365594961882665,0.535436893203884
Eclipse,knn,bootstrap,balanced,416,11545,5782,5763,3848,1927,1921,Description_Summary,200,1226,0,701,1921,1,0.267353165522502,0.633676582761251,1,0.389577375278043,0.560713469014407
Eclipse,knn,bootstrap,balanced,448,11610,5814,5796,3869,1937,1932,Description_Summary,200,1222,0,715,1932,1,0.270117113713638,0.635058556856819,1,0.387444514901712,0.558500914076782
Eclipse,knn,bootstrap,balanced,480,11541,5830,5711,3846,1943,1903,Description_Summary,200,1348,0,595,1903,1,0.238190552441954,0.619095276220977,1,0.41464164872347,0.586214394433573
Eclipse,knn,bootstrap,balanced,512,11676,5844,5832,3891,1947,1944,Description_Summary,200,1404,0,543,1944,1,0.218335343787696,0.609167671893848,1,0.419354838709677,0.590909090909091
Eclipse,knn,cv52,balanced,4,5952,2595,3357,1983,865,1118,Description_Summary,200,274,311,591,807,0.468376068376068,0.42274678111588,0.445561424745974,0.468376068376068,0.253469010175763,0.328931572629052
Eclipse,knn,cv52,balanced,8,5952,3174,2778,1983,1058,925,Description_Summary,200,532,418,526,507,0.56,0.50919651500484,0.53459825750242,0.56,0.512030798845043,0.534942182001006
Eclipse,knn,cv52,balanced,12,5952,3423,2529,1983,1140,843,Description_Summary,200,699,495,441,348,0.585427135678392,0.55893536121673,0.572181248447561,0.585427135678392,0.667621776504298,0.623828647925033
Eclipse,knn,cv52,balanced,16,5952,3665,2287,1983,1221,762,Description_Summary,200,845,517,376,245,0.620411160058737,0.605475040257649,0.612943100158193,0.620411160058737,0.775229357798165,0.689233278955954
Eclipse,knn,cv52,balanced,20,5952,3812,2140,1983,1270,713,Description_Summary,200,897,467,373,246,0.657624633431085,0.602584814216478,0.630104723823782,0.657624633431085,0.784776902887139,0.715596330275229
Eclipse,knn,cv52,balanced,24,7927,3977,3950,2641,1325,1316,Description_Summary,200,355,131,970,1185,0.730452674897119,0.450116009280742,0.590284342088931,0.730452674897119,0.230519480519481,0.350444225074037
Eclipse,knn,cv52,balanced,28,7809,4095,3714,2602,1364,1238,Description_Summary,200,346,138,1018,1100,0.714876033057851,0.480642115203022,0.597759074130436,0.714876033057851,0.239280774550484,0.358549222797927
Eclipse,knn,cv52,balanced,32,7699,4204,3495,2566,1401,1165,Description_Summary,200,433,154,968,1011,0.737649063032368,0.489135927235978,0.613392495134173,0.737649063032368,0.299861495844875,0.426390940423437
Eclipse,knn,cv52,balanced,64,8376,4740,3636,2791,1579,1212,Description_Summary,200,550,105,1029,1107,0.83969465648855,0.481741573033708,0.660718114761129,0.83969465648855,0.331925165962583,0.475778546712803
Eclipse,knn,cv52,balanced,96,9765,4998,4767,3254,1666,1588,Description_Summary,200,526,29,1140,1559,0.947747747747748,0.422378658762505,0.685063203255126,0.947747747747748,0.252278177458034,0.398484848484848
Eclipse,knn,cv52,balanced,128,9754,5191,4563,3251,1730,1521,Description_Summary,200,625,19,1105,1502,0.970496894409938,0.423858841580361,0.697177867995149,0.970496894409938,0.293841090738129,0.451100685673042
Eclipse,knn,cv52,balanced,160,10377,5319,5058,3459,1773,1686,Description_Summary,200,700,6,1073,1680,0.991501416430595,0.389756629131856,0.690629022781226,0.991501416430595,0.294117647058824,0.453661697990927
Eclipse,knn,cv52,balanced,192,10314,5406,4908,3437,1802,1635,Description_Summary,200,803,2,999,1633,0.997515527950311,0.379559270516717,0.688537399233514,0.997515527950311,0.329638752052545,0.495526072199938
Eclipse,knn,cv52,balanced,224,10844,5507,5337,3614,1835,1779,Description_Summary,200,856,0,979,1779,1,0.354967367657723,0.677483683828861,1,0.324857685009488,0.490403895731882
Eclipse,knn,cv52,balanced,256,10905,5571,5334,3634,1856,1778,Description_Summary,200,896,2,960,1776,0.997772828507795,0.350877192982456,0.674325010745126,0.997772828507795,0.335329341317365,0.501960784313725
Eclipse,knn,cv52,balanced,288,10935,5619,5316,3645,1873,1772,Description_Summary,200,913,2,960,1770,0.997814207650273,0.351648351648352,0.674731279649312,0.997814207650273,0.340290719344018,0.507504168982768
Eclipse,knn,cv52,balanced,320,11082,5667,5415,3693,1888,1805,Description_Summary,200,959,0,929,1805,1,0.33979517190929,0.669897585954645,1,0.346960926193922,0.515175933387053
Eclipse,knn,cv52,balanced,352,11351,5717,5634,3783,1905,1878,Description_Summary,200,1070,0,835,1878,1,0.307777368227055,0.653888684113527,1,0.362957937584803,0.532603285216526
Eclipse,knn,cv52,balanced,384,11496,5754,5742,3831,1917,1914,Description_Summary,200,1099,0,818,1914,1,0.299414348462665,0.649707174231332,1,0.364752738134749,0.534533073929961
Eclipse,knn,cv52,balanced,416,11545,5782,5763,3848,1927,1921,Description_Summary,200,1236,0,691,1921,1,0.264548238897397,0.632274119448698,1,0.391510928096294,0.562713407694059
Eclipse,knn,cv52,balanced,448,11610,5814,5796,3869,1937,1932,Description_Summary,200,1220,0,717,1932,1,0.270668176670442,0.635334088335221,1,0.387055837563452,0.558096980786825
Eclipse,knn,cv52,balanced,480,11541,5830,5711,3846,1943,1903,Description_Summary,200,1348,0,595,1903,1,0.238190552441954,0.619095276220977,1,0.41464164872347,0.586214394433573
Eclipse,knn,cv52,balanced,512,11676,5844,5832,3891,1947,1944,Description_Summary,200,1401,0,546,1944,1,0.219277108433735,0.609638554216867,1,0.418834080717489,0.59039190897598
Eclipse,rf,bootstrap,balanced,4,5952,2595,3357,1983,865,1118,Description_Summary,200,267,247,598,871,0.519455252918288,0.407079646017699,0.463267449467994,0.519455252918288,0.234622144112478,0.323244552058111
Eclipse,rf,bootstrap,balanced,8,5952,3174,2778,1983,1058,925,Description_Summary,200,801,576,257,349,0.581699346405229,0.424092409240924,0.502895877823076,0.581699346405229,0.696521739130435,0.633953304313415
Eclipse,rf,bootstrap,balanced,12,5952,3423,2529,1983,1140,843,Description_Summary,200,968,677,172,166,0.588449848024316,0.50887573964497,0.548662793834643,0.588449848024316,0.853615520282187,0.696653472472112
Eclipse,rf,bootstrap,balanced,16,5952,3665,2287,1983,1221,762,Description_Summary,200,1152,698,69,64,0.622702702702703,0.518796992481203,0.570749847591953,0.622702702702703,0.947368421052632,0.75146771037182
Eclipse,rf,bootstrap,balanced,20,5952,3812,2140,1983,1270,713,Description_Summary,200,1245,694,25,19,0.642083548220732,0.568181818181818,0.605132683201275,0.642083548220732,0.98496835443038,0.777396191070871
Eclipse,rf,bootstrap,balanced,24,7927,3977,3950,2641,1325,1316,Description_Summary,200,1078,474,247,842,0.694587628865979,0.226813590449954,0.460700609657967,0.694587628865979,0.561458333333333,0.620967741935484
Eclipse,rf,bootstrap,balanced,28,7809,4095,3714,2602,1364,1238,Description_Summary,200,1183,509,181,729,0.699172576832151,0.198901098901099,0.449036837866625,0.699172576832151,0.618723849372385,0.656492785793563
Eclipse,rf,bootstrap,balanced,32,7699,4204,3495,2566,1401,1165,Description_Summary,200,1192,405,209,760,0.746399499060739,0.215686274509804,0.481042886785271,0.746399499060739,0.610655737704918,0.671738517892364
Eclipse,rf,bootstrap,balanced,64,8376,4740,3636,2791,1579,1212,Description_Summary,200,1431,304,148,908,0.82478386167147,0.140151515151515,0.482467688411492,0.82478386167147,0.611799914493373,0.702503681885125
Eclipse,rf,bootstrap,balanced,96,9765,4998,4767,3254,1666,1588,Description_Summary,200,1482,213,184,1375,0.874336283185841,0.118024374599102,0.496180328892471,0.874336283185841,0.518725936296815,0.651142355008787
Eclipse,rf,bootstrap,balanced,128,9754,5191,4563,3251,1730,1521,Description_Summary,200,1625,181,105,1340,0.899778516057586,0.072664359861592,0.486221437959589,0.899778516057586,0.548060708263069,0.681198910081744
Eclipse,rf,bootstrap,balanced,160,10377,5319,5058,3459,1773,1686,Description_Summary,200,1635,126,138,1560,0.928449744463373,0.081272084805654,0.504860914634513,0.928449744463373,0.511737089201878,0.659806295399516
Eclipse,rf,bootstrap,balanced,192,10314,5406,4908,3437,1802,1635,Description_Summary,200,1662,122,140,1513,0.931614349775785,0.084694494857834,0.50815442231681,0.931614349775785,0.523464566929134,0.670296430732003
Eclipse,rf,bootstrap,balanced,224,10844,5507,5337,3614,1835,1779,Description_Summary,200,1748,91,87,1688,0.950516585100598,0.049014084507042,0.49976533480382,0.950516585100598,0.508731082654249,0.662748815165877
Eclipse,rf,bootstrap,balanced,256,10905,5571,5334,3634,1856,1778,Description_Summary,200,1773,66,83,1712,0.964110929853181,0.046239554317549,0.505175242085365,0.964110929853181,0.508751793400287,0.666040570999249
Eclipse,rf,bootstrap,balanced,288,10935,5619,5316,3645,1873,1772,Description_Summary,200,1803,60,70,1712,0.967793880837359,0.039281705948373,0.503537793392866,0.967793880837359,0.512944523470839,0.670509483079212
Eclipse,rf,bootstrap,balanced,320,11082,5667,5415,3693,1888,1805,Description_Summary,200,1815,61,73,1744,0.967484008528785,0.040176114474408,0.503830061501596,0.967484008528785,0.509974711997752,0.667893284268629
Eclipse,rf,bootstrap,balanced,352,11351,5717,5634,3783,1905,1878,Description_Summary,200,1845,46,60,1832,0.97567424643046,0.031712473572939,0.503693360001699,0.97567424643046,0.501767745444656,0.662715517241379
Eclipse,rf,bootstrap,balanced,384,11496,5754,5742,3831,1917,1914,Description_Summary,200,1872,36,45,1878,0.981132075471698,0.023400936037442,0.50226650575457,0.981132075471698,0.4992,0.661717921527041
Eclipse,rf,bootstrap,balanced,416,11545,5782,5763,3848,1927,1921,Description_Summary,200,1913,29,14,1892,0.985066941297631,0.007345225603358,0.496206083450495,0.985066941297631,0.502759526938239,0.665738646250218
Eclipse,rf,bootstrap,balanced,448,11610,5814,5796,3869,1937,1932,Description_Summary,200,1924,26,13,1906,0.986666666666667,0.006774361646691,0.496720514156679,0.986666666666667,0.502349869451697,0.665743944636678
Eclipse,rf,bootstrap,balanced,480,11541,5830,5711,3846,1943,1903,Description_Summary,200,1941,23,2,1880,0.988289205702648,0.001062699256111,0.494675952479379,0.988289205702648,0.50798220361162,0.67104580812446
Eclipse,rf,bootstrap,balanced,512,11676,5844,5832,3891,1947,1944,Description_Summary,200,1943,24,4,1920,0.987798678190137,0.002079002079002,0.49493884013457,0.987798678190137,0.502976960911209,0.666552315608919
Eclipse,rf,cv52,balanced,4,5952,2595,3357,1983,865,1118,Description_Summary,200,284,245,581,873,0.536862003780718,0.39958734525447,0.468224674517594,0.536862003780718,0.245462402765774,0.336892052194543
Eclipse,rf,cv52,balanced,8,5952,3174,2778,1983,1058,925,Description_Summary,200,778,558,280,367,0.582335329341317,0.432766615146832,0.507550972244074,0.582335329341317,0.679475982532751,0.627166465135026
Eclipse,rf,cv52,balanced,12,5952,3423,2529,1983,1140,843,Description_Summary,200,957,661,183,182,0.591470951792336,0.501369863013699,0.546420407403017,0.591470951792336,0.840210711150132,0.694232861806311
Eclipse,rf,cv52,balanced,16,5952,3665,2287,1983,1221,762,Description_Summary,200,1155,698,66,64,0.623313545601727,0.507692307692308,0.565502926647017,0.623313545601727,0.947497949138638,0.751953125
Eclipse,rf,cv52,balanced,20,5952,3812,2140,1983,1270,713,Description_Summary,200,1255,690,15,23,0.645244215938303,0.394736842105263,0.519990529021783,0.645244215938303,0.982003129890454,0.778777536456717
Eclipse,rf,cv52,balanced,24,7927,3977,3950,2641,1325,1316,Description_Summary,200,1061,471,264,845,0.692558746736292,0.238052299368801,0.465305523052547,0.692558746736292,0.556663168940189,0.617219313554392
Eclipse,rf,cv52,balanced,28,7809,4095,3714,2602,1364,1238,Description_Summary,200,1048,381,316,857,0.733379986004199,0.269394714407502,0.50138735020585,0.733379986004199,0.550131233595801,0.628674265146971
Eclipse,rf,cv52,balanced,32,7699,4204,3495,2566,1401,1165,Description_Summary,200,1168,439,233,726,0.726820161792159,0.2429614181439,0.48489078996803,0.726820161792159,0.616684266103485,0.667237932019423
Eclipse,rf,cv52,balanced,64,8376,4740,3636,2791,1579,1212,Description_Summary,200,1415,284,164,928,0.83284284873455,0.15018315018315,0.49151299945885,0.83284284873455,0.603926589842083,0.700148441365661
Eclipse,rf,cv52,balanced,96,9765,4998,4767,3254,1666,1588,Description_Summary,200,1503,205,163,1383,0.879976580796253,0.105433376455369,0.492704978625811,0.879976580796253,0.520790020790021,0.654331737048324
Eclipse,rf,cv52,balanced,128,9754,5191,4563,3251,1730,1521,Description_Summary,200,1624,176,106,1345,0.902222222222222,0.073053066850448,0.487637644536335,0.902222222222222,0.546985517009094,0.681065212832879
Eclipse,rf,cv52,balanced,160,10377,5319,5058,3459,1773,1686,Description_Summary,200,1628,136,145,1550,0.922902494331066,0.085545722713864,0.504224108522465,0.922902494331066,0.512271869100063,0.658842573856738
Eclipse,rf,cv52,balanced,192,10314,5406,4908,3437,1802,1635,Description_Summary,200,1671,108,131,1527,0.93929173693086,0.079010856453559,0.509151296692209,0.93929173693086,0.522514071294559,0.671488848704039
Eclipse,rf,cv52,balanced,224,10844,5507,5337,3614,1835,1779,Description_Summary,200,1751,86,84,1693,0.953184540010887,0.047270680922904,0.500227610466896,0.953184540010887,0.508420441347271,0.663131982579057
Eclipse,rf,cv52,balanced,256,10905,5571,5334,3634,1856,1778,Description_Summary,200,1765,68,91,1710,0.962902345881069,0.050527484730705,0.506714915305887,0.962902345881069,0.507913669064748,0.665033911077619
Eclipse,rf,cv52,balanced,288,10935,5619,5316,3645,1873,1772,Description_Summary,200,1795,72,78,1700,0.961435457953937,0.043869516310461,0.502652487132199,0.961435457953937,0.513590844062947,0.66952629615815
Eclipse,rf,cv52,balanced,320,11082,5667,5415,3693,1888,1805,Description_Summary,200,1821,59,67,1746,0.968617021276596,0.036955322669608,0.502786171973102,0.968617021276596,0.510513036164844,0.668624931154764
Eclipse,rf,cv52,balanced,352,11351,5717,5634,3783,1905,1878,Description_Summary,200,1849,43,56,1835,0.977272727272727,0.029613960867266,0.503443344069997,0.977272727272727,0.501900108577633,0.663199426111908
Eclipse,rf,cv52,balanced,384,11496,5754,5742,3831,1917,1914,Description_Summary,200,1877,44,40,1870,0.977095262883915,0.020942408376963,0.499018835630439,0.977095262883915,0.500934080597812,0.662314749470713
Eclipse,rf,cv52,balanced,416,11545,5782,5763,3848,1927,1921,Description_Summary,200,1909,30,18,1891,0.98452810727179,0.009429020429544,0.496978563850667,0.98452810727179,0.502368421052632,0.665272695591566
Eclipse,rf,cv52,balanced,448,11610,5814,5796,3869,1937,1932,Description_Summary,200,1926,33,11,1899,0.983154670750383,0.005759162303665,0.494456916527024,0.983154670750383,0.503529411764706,0.66597510373444
Eclipse,rf,cv52,balanced,480,11541,5830,5711,3846,1943,1903,Description_Summary,200,1940,27,3,1876,0.986273512963904,0.001596593932943,0.493935053448424,0.986273512963904,0.508385744234801,0.670932042192634
Eclipse,rf,cv52,balanced,512,11676,5844,5832,3891,1947,1944,Description_Summary,200,1943,23,4,1921,0.988301119023398,0.002077922077922,0.49518952055066,0.988301119023398,0.502846790890269,0.666552315608919
Eclipse,svmRadial,bootstrap,balanced,4,5952,2595,3357,1983,865,1118,Description_Summary,200,195,144,670,974,0.575221238938053,0.407542579075426,0.491381909006739,0.575221238938053,0.166809238665526,0.258620689655172
Eclipse,svmRadial,bootstrap,balanced,8,5952,3174,2778,1983,1058,925,Description_Summary,200,849,643,209,282,0.569034852546917,0.425661914460285,0.497348383503601,0.569034852546917,0.750663129973475,0.647350362180709
Eclipse,svmRadial,bootstrap,balanced,12,5952,3423,2529,1983,1140,843,Description_Summary,200,1139,838,1,5,0.576125442589782,0.166666666666667,0.371396054628225,0.576125442589782,0.995629370629371,0.729894264658763
Eclipse,svmRadial,bootstrap,balanced,16,5952,3665,2287,1983,1221,762,Description_Summary,200,1221,762,0,0,0.615733736762481,NA,NA,0.615733736762481,1,0.762172284644195
Eclipse,svmRadial,bootstrap,balanced,20,5952,3812,2140,1983,1270,713,Description_Summary,200,1270,713,0,0,0.640443772062532,NA,NA,0.640443772062532,1,0.780817706732247
Eclipse,svmRadial,bootstrap,balanced,24,7927,3977,3950,2641,1325,1316,Description_Summary,200,848,378,477,938,0.691680261011419,0.337102473498233,0.514391367254826,0.691680261011419,0.474804031354983,0.563081009296149
Eclipse,svmRadial,bootstrap,balanced,28,7809,4095,3714,2602,1364,1238,Description_Summary,200,852,372,512,866,0.696078431372549,0.37155297532656,0.533815703349555,0.696078431372549,0.49592549476135,0.579197824609109
Eclipse,svmRadial,bootstrap,balanced,32,7699,4204,3495,2566,1401,1165,Description_Summary,200,998,440,403,725,0.694019471488178,0.357269503546099,0.525644487517139,0.694019471488178,0.579222286709228,0.6314457450174
Eclipse,svmRadial,bootstrap,balanced,64,8376,4740,3636,2791,1579,1212,Description_Summary,200,1257,337,322,875,0.788582183186951,0.269005847953216,0.528794015570084,0.788582183186951,0.589587242026266,0.674718196457327
Eclipse,svmRadial,bootstrap,balanced,96,9765,4998,4767,3254,1666,1588,Description_Summary,200,1256,206,410,1382,0.859097127222982,0.228794642857143,0.543945885040063,0.859097127222982,0.476118271417741,0.612682926829268
Eclipse,svmRadial,bootstrap,balanced,128,9754,5191,4563,3251,1730,1521,Description_Summary,200,1400,182,330,1339,0.884955752212389,0.197723187537448,0.541339469874919,0.884955752212389,0.511135450894487,0.647998148576718
Eclipse,svmRadial,bootstrap,balanced,160,10377,5319,5058,3459,1773,1686,Description_Summary,200,1457,135,316,1551,0.915201005025126,0.169255490091055,0.54222824755809,0.915201005025126,0.484375,0.633478260869565
Eclipse,svmRadial,bootstrap,balanced,192,10314,5406,4908,3437,1802,1635,Description_Summary,200,1514,73,288,1562,0.954001260239446,0.155675675675676,0.554838467957561,0.954001260239446,0.492197659297789,0.649367360068625
Eclipse,svmRadial,bootstrap,balanced,224,10844,5507,5337,3614,1835,1779,Description_Summary,200,1597,51,238,1728,0.969053398058252,0.121057985757884,0.545055691908068,0.969053398058252,0.480300751879699,0.642268248542127
Eclipse,svmRadial,bootstrap,balanced,256,10905,5571,5334,3634,1856,1778,Description_Summary,200,1632,41,224,1737,0.975493126120741,0.114227434982152,0.544860280551447,0.975493126120741,0.484416740872663,0.64736215787386
Eclipse,svmRadial,bootstrap,balanced,288,10935,5619,5316,3645,1873,1772,Description_Summary,200,1663,30,210,1742,0.982279976373302,0.107581967213115,0.544930971793208,0.982279976373302,0.488399412628488,0.652412710867007
Eclipse,svmRadial,bootstrap,balanced,320,11082,5667,5415,3693,1888,1805,Description_Summary,200,1719,28,169,1777,0.983972524327418,0.086844809866393,0.535408667096905,0.983972524327418,0.491704805491991,0.655731451459088
Eclipse,svmRadial,bootstrap,balanced,352,11351,5717,5634,3783,1905,1878,Description_Summary,200,1760,6,145,1872,0.996602491506229,0.071888943976202,0.534245717741216,0.996602491506229,0.484581497797357,0.652093367914042
Eclipse,svmRadial,bootstrap,balanced,384,11496,5754,5742,3831,1917,1914,Description_Summary,200,1811,1,106,1913,0.999448123620309,0.052501238236751,0.52597468092853,0.999448123620309,0.486305048335124,0.654263005780347
Eclipse,svmRadial,bootstrap,balanced,416,11545,5782,5763,3848,1927,1921,Description_Summary,200,1838,1,89,1920,0.999456226209897,0.044300647088104,0.521878436649,0.999456226209897,0.489089941458222,0.656780418081115
Eclipse,svmRadial,bootstrap,balanced,448,11610,5814,5796,3869,1937,1932,Description_Summary,200,1862,0,75,1932,1,0.037369207772795,0.518684603886398,1,0.490774907749078,0.658415841584158
Eclipse,svmRadial,bootstrap,balanced,480,11541,5830,5711,3846,1943,1903,Description_Summary,200,1883,5,60,1898,0.997351694915254,0.030643513789581,0.513997604352418,0.997351694915254,0.498016397778366,0.66431469394955
Eclipse,svmRadial,bootstrap,balanced,512,11676,5844,5832,3891,1947,1944,Description_Summary,200,1900,0,47,1944,1,0.023606228026118,0.511803114013059,1,0.494276795005203,0.661559888579387
Eclipse,svmRadial,cv52,balanced,4,5952,2595,3357,1983,865,1118,Description_Summary,200,277,239,588,879,0.536821705426357,0.40081799591002,0.468819850668188,0.536821705426357,0.23961937716263,0.33133971291866
Eclipse,svmRadial,cv52,balanced,8,5952,3174,2778,1983,1058,925,Description_Summary,200,723,533,335,392,0.575636942675159,0.46079779917469,0.518217370924925,0.575636942675159,0.648430493273543,0.609869253479544
Eclipse,svmRadial,cv52,balanced,12,5952,3423,2529,1983,1140,843,Description_Summary,200,1078,771,62,72,0.583017847485127,0.462686567164179,0.522852207324653,0.583017847485127,0.937391304347826,0.7189063021007
Eclipse,svmRadial,cv52,balanced,16,5952,3665,2287,1983,1221,762,Description_Summary,200,1210,754,11,8,0.616089613034623,0.578947368421053,0.597518490727838,0.616089613034623,0.993431855500821,0.760527969830295
Eclipse,svmRadial,cv52,balanced,20,5952,3812,2140,1983,1270,713,Description_Summary,200,1261,701,9,12,0.642711518858308,0.428571428571429,0.535641473714868,0.642711518858308,0.99057344854674,0.779598145285935
Eclipse,svmRadial,cv52,balanced,24,7927,3977,3950,2641,1325,1316,Description_Summary,200,825,361,500,955,0.695615514333895,0.343642611683849,0.519629063008872,0.695615514333895,0.463483146067416,0.556304787592718
Eclipse,svmRadial,cv52,balanced,28,7809,4095,3714,2602,1364,1238,Description_Summary,200,850,399,514,839,0.680544435548439,0.37989652623799,0.530220480893214,0.680544435548439,0.503256364712848,0.578624914908101
Eclipse,svmRadial,cv52,balanced,32,7699,4204,3495,2566,1401,1165,Description_Summary,200,1004,421,397,744,0.704561403508772,0.347940403155127,0.52625090333195,0.704561403508772,0.574370709382151,0.632839583989915
Eclipse,svmRadial,cv52,balanced,64,8376,4740,3636,2791,1579,1212,Description_Summary,200,1265,336,314,876,0.790131168019988,0.263865546218487,0.526998357119237,0.790131168019988,0.5908453993461,0.676109032602886
Eclipse,svmRadial,cv52,balanced,96,9765,4998,4767,3254,1666,1588,Description_Summary,200,1259,210,407,1378,0.857045609257999,0.228011204481793,0.542528406869896,0.857045609257999,0.47743648084945,0.613248904042864
Eclipse,svmRadial,cv52,balanced,128,9754,5191,4563,3251,1730,1521,Description_Summary,200,1397,190,333,1331,0.880277252678009,0.200120192307692,0.540198722492851,0.880277252678009,0.512096774193548,0.647508690614137
Eclipse,svmRadial,cv52,balanced,160,10377,5319,5058,3459,1773,1686,Description_Summary,200,1449,120,324,1566,0.923518164435946,0.171428571428571,0.547473367932259,0.923518164435946,0.480597014925373,0.632198952879581
Eclipse,svmRadial,cv52,balanced,192,10314,5406,4908,3437,1802,1635,Description_Summary,200,1491,71,311,1564,0.954545454545455,0.165866666666667,0.560206060606061,0.954545454545455,0.488052373158756,0.645873944119558
Eclipse,svmRadial,cv52,balanced,224,10844,5507,5337,3614,1835,1779,Description_Summary,200,1583,41,252,1738,0.974753694581281,0.126633165829146,0.550693430205213,0.974753694581281,0.476663655525444,0.640242669362993
Eclipse,svmRadial,cv52,balanced,256,10905,5571,5334,3634,1856,1778,Description_Summary,200,1626,39,230,1739,0.976576576576577,0.116810563737938,0.546693570157257,0.976576576576577,0.483209509658247,0.646520874751491
Eclipse,svmRadial,cv52,balanced,288,10935,5619,5316,3645,1873,1772,Description_Summary,200,1665,27,208,1745,0.984042553191489,0.106502816180236,0.545272684685862,0.984042553191489,0.488269794721408,0.652685221481772
Eclipse,svmRadial,cv52,balanced,320,11082,5667,5415,3693,1888,1805,Description_Summary,200,1715,25,173,1780,0.985632183908046,0.088581669226831,0.537106926567438,0.985632183908046,0.490701001430615,0.655205348615091
Eclipse,svmRadial,cv52,balanced,352,11351,5717,5634,3783,1905,1878,Description_Summary,200,1768,5,137,1873,0.997179921037789,0.0681592039801,0.532669562508944,0.997179921037789,0.485580884372425,0.653121536756557
Eclipse,svmRadial,cv52,balanced,384,11496,5754,5742,3831,1917,1914,Description_Summary,200,1812,9,105,1905,0.99505766062603,0.052238805970149,0.523648233298089,0.99505766062603,0.487489911218725,0.654387865655471
Eclipse,svmRadial,cv52,balanced,416,11545,5782,5763,3848,1927,1921,Description_Summary,200,1835,3,92,1918,0.998367791077258,0.045771144278607,0.522069467677932,0.998367791077258,0.488942179589662,0.656412090860311
Eclipse,svmRadial,cv52,balanced,448,11610,5814,5796,3869,1937,1932,Description_Summary,200,1869,0,68,1932,1,0.034,0.517,1,0.49171270718232,0.659259259259259
Eclipse,svmRadial,cv52,balanced,480,11541,5830,5711,3846,1943,1903,Description_Summary,200,1880,1,63,1902,0.999468367889421,0.03206106870229,0.515764718295855,0.999468367889421,0.497091485986251,0.663959032315027
Eclipse,svmRadial,cv52,balanced,512,11676,5844,5832,3891,1947,1944,Description_Summary,200,1902,7,45,1937,0.996333158721844,0.022704339051463,0.509518748886653,0.996333158721844,0.495441521229487,0.661795407098121
Eclipse,knn,bootstrap,balanced,4,5607,2451,3156,1867,816,1051,Summary,200,335,385,481,666,0.465277777777778,0.419354838709677,0.442316308243728,0.465277777777778,0.334665334665335,0.389308541545613
Eclipse,knn,bootstrap,balanced,8,5607,3000,2607,1867,999,868,Summary,200,603,491,396,377,0.551188299817185,0.51228978007762,0.531739039947402,0.551188299817185,0.61530612244898,0.581485053037608
Eclipse,knn,bootstrap,balanced,12,5606,3236,2370,1868,1078,790,Summary,200,758,513,320,277,0.596380802517703,0.536013400335008,0.566197101426355,0.596380802517703,0.732367149758454,0.657415437987858
Eclipse,knn,bootstrap,balanced,16,5606,3465,2141,1868,1155,713,Summary,200,901,536,254,177,0.627000695894224,0.589327146171694,0.608163921032959,0.627000695894224,0.835807050092764,0.716500994035785
Eclipse,knn,bootstrap,balanced,20,5606,3605,2001,1868,1201,667,Summary,200,1003,533,198,134,0.652994791666667,0.596385542168675,0.624690166917671,0.652994791666667,0.882145998240985,0.750467639356528
Eclipse,knn,bootstrap,balanced,24,7452,3759,3693,2484,1253,1231,Summary,200,574,300,679,931,0.65675057208238,0.421739130434783,0.539244851258581,0.65675057208238,0.381395348837209,0.48255569567045
Eclipse,knn,bootstrap,balanced,28,7341,3871,3470,2446,1290,1156,Summary,200,633,342,657,814,0.649230769230769,0.446634942216179,0.547932855723474,0.649230769230769,0.437456807187284,0.522708505367465
Eclipse,knn,bootstrap,balanced,32,7241,3972,3269,2412,1323,1089,Summary,200,664,335,659,754,0.664664664664665,0.466383581033263,0.565524122848964,0.664664664664665,0.468265162200282,0.549441456350848
Eclipse,knn,bootstrap,balanced,64,7870,4474,3396,2622,1491,1131,Summary,200,835,279,656,852,0.749551166965889,0.435013262599469,0.592282214782679,0.749551166965889,0.494961470065205,0.596215637272403
Eclipse,knn,bootstrap,balanced,96,9164,4716,4448,3054,1572,1482,Summary,200,858,188,714,1294,0.820267686424474,0.355577689243028,0.587922687833751,0.820267686424474,0.398698884758364,0.536585365853658
Eclipse,knn,bootstrap,balanced,128,9153,4896,4257,3051,1632,1419,Summary,200,947,143,685,1276,0.868807339449541,0.34931157572667,0.609059457588106,0.868807339449541,0.42600089968511,0.571687292484153
Eclipse,knn,bootstrap,balanced,160,9748,5014,4734,3249,1671,1578,Summary,200,1008,96,663,1482,0.91304347826087,0.309090909090909,0.611067193675889,0.91304347826087,0.404819277108434,0.56093489148581
Eclipse,knn,bootstrap,balanced,192,9698,5094,4604,3232,1698,1534,Summary,200,1089,77,609,1457,0.933962264150943,0.294772507260407,0.614367385705675,0.933962264150943,0.427729772191673,0.586745689655172
Eclipse,knn,bootstrap,balanced,224,10168,5191,4977,3389,1730,1659,Summary,200,1148,94,582,1565,0.924315619967794,0.271075919888216,0.597695769928005,0.924315619967794,0.423147806855879,0.580530973451327
Eclipse,knn,bootstrap,balanced,256,10238,5250,4988,3411,1749,1662,Summary,200,1207,71,542,1591,0.944444444444444,0.254102203469292,0.599273323956868,0.944444444444444,0.431379556826305,0.592247301275761
Eclipse,knn,bootstrap,balanced,288,10574,5295,5279,3524,1765,1759,Summary,200,1206,63,559,1696,0.950354609929078,0.247893569844789,0.599124089886934,0.950354609929078,0.415575465196416,0.578278590266123
Eclipse,knn,bootstrap,balanced,320,10412,5339,5073,3470,1779,1691,Summary,200,1274,73,505,1618,0.945805493689681,0.237870937352803,0.591838215521242,0.945805493689681,0.440525587828492,0.601085161594716
Eclipse,knn,bootstrap,balanced,352,10608,5388,5220,3536,1796,1740,Summary,200,1355,53,441,1687,0.962357954545455,0.207236842105263,0.584797398325359,0.962357954545455,0.44543063773833,0.608988764044944
Eclipse,knn,bootstrap,balanced,384,10772,5421,5351,3590,1807,1783,Summary,200,1421,50,386,1733,0.966009517335146,0.182161396885323,0.574085457110235,0.966009517335146,0.450538998097654,0.614486486486487
Eclipse,knn,bootstrap,balanced,416,10803,5448,5355,3601,1816,1785,Summary,200,1458,56,358,1729,0.963011889035667,0.171538092956397,0.567274990996032,0.963011889035667,0.457483526827738,0.620293554562859
Eclipse,knn,bootstrap,balanced,448,10833,5478,5355,3611,1826,1785,Summary,200,1526,28,300,1757,0.981981981981982,0.145843461351483,0.563912721666732,0.981981981981982,0.464818763326226,0.630969609261939
Eclipse,knn,bootstrap,balanced,480,10970,5494,5476,3656,1831,1825,Summary,200,1538,28,293,1797,0.982120051085568,0.140191387559809,0.561155719322688,0.982120051085568,0.461169415292354,0.627627014894919
Eclipse,knn,bootstrap,balanced,512,11010,5508,5502,3669,1835,1834,Summary,200,1535,21,300,1813,0.986503856041131,0.141978230004733,0.564241043022932,0.986503856041131,0.458482676224612,0.626019575856444
Eclipse,knn,cv52,balanced,4,5607,2451,3156,1867,816,1051,Summary,200,330,411,486,640,0.445344129554656,0.431616341030195,0.438480235292426,0.445344129554656,0.34020618556701,0.385739333722969
Eclipse,knn,cv52,balanced,8,5607,3000,2607,1867,999,868,Summary,200,603,493,396,375,0.550182481751825,0.513618677042802,0.531900579397313,0.550182481751825,0.616564417177914,0.581485053037608
Eclipse,knn,cv52,balanced,12,5606,3236,2370,1868,1078,790,Summary,200,773,530,305,260,0.593246354566385,0.539823008849557,0.566534681707971,0.593246354566385,0.748305905130687,0.661815068493151
Eclipse,knn,cv52,balanced,16,5606,3465,2141,1868,1155,713,Summary,200,879,543,276,170,0.618143459915612,0.618834080717489,0.61848877031655,0.618143459915612,0.837940896091516,0.711452853095913
Eclipse,knn,cv52,balanced,20,5606,3605,2001,1868,1201,667,Summary,200,992,511,209,156,0.660013306719894,0.572602739726027,0.616308023222961,0.660013306719894,0.86411149825784,0.748396831384383
Eclipse,knn,cv52,balanced,24,7452,3759,3693,2484,1253,1231,Summary,200,565,340,688,891,0.624309392265193,0.435718809373021,0.530014100819107,0.624309392265193,0.388049450549451,0.478610758153325
Eclipse,knn,cv52,balanced,28,7341,3871,3470,2446,1290,1156,Summary,200,668,368,622,788,0.644787644787645,0.44113475177305,0.542961198280347,0.644787644787645,0.458791208791209,0.536115569823435
Eclipse,knn,cv52,balanced,32,7241,3972,3269,2412,1323,1089,Summary,200,676,356,647,733,0.655038759689923,0.468840579710145,0.561939669700034,0.655038759689923,0.479772888573456,0.553871364195002
Eclipse,knn,cv52,balanced,64,7870,4474,3396,2622,1491,1131,Summary,200,831,291,660,840,0.740641711229946,0.44,0.590320855614973,0.740641711229946,0.497307001795332,0.595059076262084
Eclipse,knn,cv52,balanced,96,9164,4716,4448,3054,1572,1482,Summary,200,857,179,715,1303,0.827220077220077,0.354311199207136,0.590765638213607,0.827220077220077,0.396759259259259,0.536295369211514
Eclipse,knn,cv52,balanced,128,9153,4896,4257,3051,1632,1419,Summary,200,960,134,672,1285,0.877513711151737,0.343382728666326,0.610448219909031,0.877513711151737,0.427616926503341,0.575022461814915
Eclipse,knn,cv52,balanced,160,9748,5014,4734,3249,1671,1578,Summary,200,1009,90,662,1488,0.91810737033667,0.307906976744186,0.613007173540428,0.91810737033667,0.404084901882259,0.561179087875417
Eclipse,knn,cv52,balanced,192,9698,5094,4604,3232,1698,1534,Summary,200,1100,91,598,1443,0.923593618807725,0.292993630573248,0.608293624690487,0.923593618807725,0.432559968541093,0.589180503481521
Eclipse,knn,cv52,balanced,224,10168,5191,4977,3389,1730,1659,Summary,200,1167,95,563,1564,0.924722662440571,0.264692054536906,0.594707358488738,0.924722662440571,0.427316001464665,0.584522915101428
Eclipse,knn,cv52,balanced,256,10238,5250,4988,3411,1749,1662,Summary,200,1207,67,542,1595,0.947409733124019,0.253626579316799,0.600518156220409,0.947409733124019,0.430763740185582,0.592247301275761
Eclipse,knn,cv52,balanced,288,10574,5295,5279,3524,1765,1759,Summary,200,1190,58,575,1701,0.953525641025641,0.252636203866432,0.603080922446037,0.953525641025641,0.411622276029056,0.575018120318918
Eclipse,knn,cv52,balanced,320,10412,5339,5073,3470,1779,1691,Summary,200,1265,79,514,1612,0.941220238095238,0.241768579492004,0.591494408793621,0.941220238095238,0.439694125825513,0.599384032219853
Eclipse,knn,cv52,balanced,352,10608,5388,5220,3536,1796,1740,Summary,200,1347,41,449,1699,0.970461095100865,0.20903165735568,0.589746376228272,0.970461095100865,0.442219304005253,0.607577807848444
Eclipse,knn,cv52,balanced,384,10772,5421,5351,3590,1807,1783,Summary,200,1428,57,379,1726,0.961616161616162,0.180047505938242,0.570831833777202,0.961616161616162,0.452758402029169,0.615649924552705
Eclipse,knn,cv52,balanced,416,10803,5448,5355,3601,1816,1785,Summary,200,1464,45,352,1740,0.970178926441352,0.168260038240918,0.569219482341135,0.970178926441352,0.456928838951311,0.621260343730108
Eclipse,knn,cv52,balanced,448,10833,5478,5355,3611,1826,1785,Summary,200,1513,25,313,1760,0.983745123537061,0.150988904968644,0.567367014252853,0.983745123537061,0.46226703330278,0.628975265017668
Eclipse,knn,cv52,balanced,480,10970,5494,5476,3656,1831,1825,Summary,200,1533,25,298,1800,0.98395378690629,0.142040038131554,0.562996912518922,0.98395378690629,0.45994599459946,0.626865671641791
Eclipse,knn,cv52,balanced,512,11010,5508,5502,3669,1835,1834,Summary,200,1532,30,303,1804,0.980793854033291,0.143806359753204,0.562300106893247,0.980793854033291,0.459232613908873,0.625561453654553
Eclipse,rf,bootstrap,balanced,4,5607,2451,3156,1867,816,1051,Summary,200,202,186,614,865,0.520618556701031,0.415145368492224,0.467881962596628,0.520618556701031,0.189315838800375,0.27766323024055
Eclipse,rf,bootstrap,balanced,8,5607,3000,2607,1867,999,868,Summary,200,791,672,208,196,0.54066985645933,0.514851485148515,0.527760670803923,0.54066985645933,0.801418439716312,0.645714285714286
Eclipse,rf,bootstrap,balanced,12,5606,3236,2370,1868,1078,790,Summary,200,977,684,101,106,0.588199879590608,0.48792270531401,0.538061292452309,0.588199879590608,0.902123730378578,0.712099125364431
Eclipse,rf,bootstrap,balanced,16,5606,3465,2141,1868,1155,713,Summary,200,1082,641,73,72,0.627974463145676,0.503448275862069,0.565711369503873,0.627974463145676,0.937608318890815,0.752172401807438
Eclipse,rf,bootstrap,balanced,20,5606,3605,2001,1868,1201,667,Summary,200,1147,623,54,44,0.648022598870057,0.551020408163265,0.599521503516661,0.648022598870057,0.963056255247691,0.774738264099966
Eclipse,rf,bootstrap,balanced,24,7452,3759,3693,2484,1253,1231,Summary,200,933,463,320,768,0.668338108882522,0.294117647058824,0.481227877970673,0.668338108882522,0.548500881834215,0.602518566354537
Eclipse,rf,bootstrap,balanced,28,7341,3871,3470,2446,1290,1156,Summary,200,947,386,343,770,0.710427606901725,0.308176100628931,0.509301853765328,0.710427606901725,0.551543389633081,0.620983606557377
Eclipse,rf,bootstrap,balanced,32,7241,3972,3269,2412,1323,1089,Summary,200,1017,425,306,664,0.705270457697642,0.315463917525773,0.510367187611708,0.705270457697642,0.604997025580012,0.651296829971182
Eclipse,rf,bootstrap,balanced,64,7870,4474,3396,2622,1491,1131,Summary,200,1256,335,235,796,0.789440603394092,0.227934044616877,0.508687324005484,0.789440603394092,0.612085769980507,0.689541586604447
Eclipse,rf,bootstrap,balanced,96,9164,4716,4448,3054,1572,1482,Summary,200,1366,251,206,1231,0.844774273345702,0.143354210160056,0.494064241752879,0.844774273345702,0.525991528686946,0.648315140009492
Eclipse,rf,bootstrap,balanced,128,9153,4896,4257,3051,1632,1419,Summary,200,1433,176,199,1243,0.890615288999378,0.138002773925104,0.514309031462241,0.890615288999378,0.535500747384155,0.668844807467911
Eclipse,rf,bootstrap,balanced,160,9748,5014,4734,3249,1671,1578,Summary,200,1470,147,201,1431,0.909090909090909,0.123161764705882,0.516126336898396,0.909090909090909,0.506721820062048,0.650730411686587
Eclipse,rf,bootstrap,balanced,192,9698,5094,4604,3232,1698,1534,Summary,200,1538,133,160,1401,0.920406941950928,0.102498398462524,0.511452670206726,0.920406941950928,0.523307247363049,0.667245119305857
Eclipse,rf,bootstrap,balanced,224,10168,5191,4977,3389,1730,1659,Summary,200,1568,116,162,1543,0.931116389548694,0.095014662756598,0.513065526152646,0.931116389548694,0.50401800064288,0.654014598540146
Eclipse,rf,bootstrap,balanced,256,10238,5250,4988,3411,1749,1662,Summary,200,1629,94,120,1568,0.945443993035403,0.071090047393365,0.508267020214384,0.945443993035403,0.509540193931811,0.66219512195122
Eclipse,rf,bootstrap,balanced,288,10574,5295,5279,3524,1765,1759,Summary,200,1636,99,129,1660,0.942939481268012,0.072107322526551,0.507523401897281,0.942939481268012,0.496359223300971,0.650367720135162
Eclipse,rf,bootstrap,balanced,320,10412,5339,5073,3470,1779,1691,Summary,200,1676,65,103,1626,0.962665134979897,0.059572006940428,0.511118570960162,0.962665134979897,0.507571168988492,0.664683720007932
Eclipse,rf,bootstrap,balanced,352,10608,5388,5220,3536,1796,1740,Summary,200,1710,57,86,1683,0.967741935483871,0.048615036743923,0.508178486113897,0.967741935483871,0.503978779840849,0.662790697674419
Eclipse,rf,bootstrap,balanced,384,10772,5421,5351,3590,1807,1783,Summary,200,1726,52,81,1731,0.970753655793026,0.044701986754967,0.507727821273996,0.970753655793026,0.499276829621059,0.659407831900669
Eclipse,rf,bootstrap,balanced,416,10803,5448,5355,3601,1816,1785,Summary,200,1750,36,66,1749,0.979843225083987,0.036363636363636,0.508103430723811,0.979843225083987,0.500142897970849,0.662251655629139
Eclipse,rf,bootstrap,balanced,448,10833,5478,5355,3611,1826,1785,Summary,200,1761,28,65,1757,0.984348798211291,0.035675082327113,0.510011940269202,0.984348798211291,0.500568504832291,0.663651780667044
Eclipse,rf,bootstrap,balanced,480,10970,5494,5476,3656,1831,1825,Summary,200,1781,36,50,1789,0.980187121629059,0.027188689505166,0.503687905567112,0.980187121629059,0.498879551820728,0.661221459068127
Eclipse,rf,bootstrap,balanced,512,11010,5508,5502,3669,1835,1834,Summary,200,1793,37,42,1797,0.979781420765027,0.022838499184339,0.501309959974683,0.979781420765027,0.499442896935933,0.661623616236162
Eclipse,rf,cv52,balanced,4,5607,2451,3156,1867,816,1051,Summary,200,236,201,580,850,0.540045766590389,0.405594405594406,0.472820086092397,0.540045766590389,0.21731123388582,0.309914642153644
Eclipse,rf,cv52,balanced,8,5607,3000,2607,1867,999,868,Summary,200,798,646,201,222,0.552631578947368,0.475177304964539,0.513904441955954,0.552631578947368,0.782352941176471,0.647727272727273
Eclipse,rf,cv52,balanced,12,5606,3236,2370,1868,1078,790,Summary,200,957,673,121,117,0.587116564417178,0.508403361344538,0.547759962880858,0.587116564417178,0.891061452513967,0.707840236686391
Eclipse,rf,cv52,balanced,16,5606,3465,2141,1868,1155,713,Summary,200,1089,641,66,72,0.629479768786127,0.478260869565217,0.553870319175672,0.629479768786127,0.937984496124031,0.75337253545486
Eclipse,rf,cv52,balanced,20,5606,3605,2001,1868,1201,667,Summary,200,1136,624,65,43,0.645454545454546,0.601851851851852,0.623653198653199,0.645454545454546,0.963528413910093,0.773052058523307
Eclipse,rf,cv52,balanced,24,7452,3759,3693,2484,1253,1231,Summary,200,932,442,321,789,0.678311499272198,0.289189189189189,0.483750344230694,0.678311499272198,0.541545613015689,0.602261712439418
Eclipse,rf,cv52,balanced,28,7341,3871,3470,2446,1290,1156,Summary,200,942,405,348,751,0.699331848552339,0.316651501364877,0.507991674958608,0.699331848552339,0.556408741878322,0.619736842105263
Eclipse,rf,cv52,balanced,32,7241,3972,3269,2412,1323,1089,Summary,200,1005,419,318,670,0.705758426966292,0.321862348178138,0.513810387572215,0.705758426966292,0.6,0.648596321393998
Eclipse,rf,cv52,balanced,64,7870,4474,3396,2622,1491,1131,Summary,200,1236,325,255,806,0.791800128122998,0.240339302544769,0.516069715333884,0.791800128122998,0.605288932419197,0.686094920899251
Eclipse,rf,cv52,balanced,96,9164,4716,4448,3054,1572,1482,Summary,200,1365,245,207,1237,0.847826086956522,0.143351800554017,0.495588943755269,0.847826086956522,0.524596464258263,0.648148148148148
Eclipse,rf,cv52,balanced,128,9153,4896,4257,3051,1632,1419,Summary,200,1442,181,190,1238,0.888478126925447,0.133053221288515,0.510765674106981,0.888478126925447,0.538059701492537,0.670230072042761
Eclipse,rf,cv52,balanced,160,9748,5014,4734,3249,1671,1578,Summary,200,1488,172,183,1406,0.896385542168675,0.115166771554437,0.505776156861556,0.896385542168675,0.514167242570836,0.653491436100132
Eclipse,rf,cv52,balanced,192,9698,5094,4604,3232,1698,1534,Summary,200,1534,123,164,1411,0.925769462884731,0.104126984126984,0.514948223505858,0.925769462884731,0.52088285229202,0.666666666666667
Eclipse,rf,cv52,balanced,224,10168,5191,4977,3389,1730,1659,Summary,200,1568,100,162,1559,0.940047961630695,0.094131319000581,0.517089640315638,0.940047961630695,0.501439078989447,0.654014598540146
Eclipse,rf,cv52,balanced,256,10238,5250,4988,3411,1749,1662,Summary,200,1632,101,117,1561,0.941719561454126,0.069725864123957,0.505722712789041,0.941719561454126,0.511118070779831,0.662606577344702
Eclipse,rf,cv52,balanced,288,10574,5295,5279,3524,1765,1759,Summary,200,1621,74,144,1685,0.956342182890855,0.078731547293603,0.517536865092229,0.956342182890855,0.490320629159105,0.648270345930814
Eclipse,rf,cv52,balanced,320,10412,5339,5073,3470,1779,1691,Summary,200,1677,75,102,1616,0.957191780821918,0.059371362048894,0.508281571435406,0.957191780821918,0.509262071059824,0.664816650148662
Eclipse,rf,cv52,balanced,352,10608,5388,5220,3536,1796,1740,Summary,200,1707,54,89,1686,0.969335604770017,0.050140845070423,0.50973822492022,0.969335604770017,0.503094606542882,0.662398137369034
Eclipse,rf,cv52,balanced,384,10772,5421,5351,3590,1807,1783,Summary,200,1728,63,79,1720,0.964824120603015,0.043913285158421,0.504368702880718,0.964824120603015,0.501160092807425,0.659667875548769
Eclipse,rf,cv52,balanced,416,10803,5448,5355,3601,1816,1785,Summary,200,1746,50,70,1735,0.972160356347439,0.038781163434903,0.505470759891171,0.972160356347439,0.501580005745475,0.661739624786811
Eclipse,rf,cv52,balanced,448,10833,5478,5355,3611,1826,1785,Summary,200,1758,29,68,1756,0.983771684387241,0.037280701754386,0.510526193070814,0.983771684387241,0.500284575981787,0.663271080928127
Eclipse,rf,cv52,balanced,480,10970,5494,5476,3656,1831,1825,Summary,200,1779,28,52,1797,0.984504703929164,0.028123309897242,0.506314006913203,0.984504703929164,0.49748322147651,0.660969719487275
Eclipse,rf,cv52,balanced,512,11010,5508,5502,3669,1835,1834,Summary,200,1783,36,52,1798,0.980208905992303,0.028108108108108,0.504158507050206,0.980208905992303,0.497905612957274,0.66037037037037
Eclipse,svmRadial,bootstrap,balanced,4,5607,2451,3156,1867,816,1051,Summary,200,26,21,790,1030,0.553191489361702,0.434065934065934,0.493628711713818,0.553191489361702,0.024621212121212,0.047144152311877
Eclipse,svmRadial,bootstrap,balanced,8,5607,3000,2607,1867,999,868,Summary,200,869,759,130,109,0.533783783783784,0.543933054393305,0.538858419088545,0.533783783783784,0.888548057259714,0.666922486569455
Eclipse,svmRadial,bootstrap,balanced,12,5606,3236,2370,1868,1078,790,Summary,200,1069,781,9,9,0.577837837837838,0.5,0.538918918918919,0.577837837837838,0.99165120593692,0.730191256830601
Eclipse,svmRadial,bootstrap,balanced,16,5606,3465,2141,1868,1155,713,Summary,200,1155,713,0,0,0.61830835117773,NA,NA,0.61830835117773,1,0.764141581210718
Eclipse,svmRadial,bootstrap,balanced,20,5606,3605,2001,1868,1201,667,Summary,200,1200,666,1,1,0.643086816720257,0.5,0.571543408360129,0.643086816720257,0.999167360532889,0.78252363873492
Eclipse,svmRadial,bootstrap,balanced,24,7452,3759,3693,2484,1253,1231,Summary,200,696,386,557,845,0.643253234750462,0.397289586305278,0.52027141052787,0.643253234750462,0.45165476963011,0.530690049561571
Eclipse,svmRadial,bootstrap,balanced,28,7341,3871,3470,2446,1290,1156,Summary,200,823,402,467,754,0.671836734693878,0.382473382473382,0.52715505858363,0.671836734693878,0.521876981610653,0.587437544610992
Eclipse,svmRadial,bootstrap,balanced,32,7241,3972,3269,2412,1323,1089,Summary,200,893,449,430,640,0.665424739195231,0.401869158878505,0.533646949036868,0.665424739195231,0.582517938682322,0.621217391304348
Eclipse,svmRadial,bootstrap,balanced,64,7870,4474,3396,2622,1491,1131,Summary,200,1015,374,476,757,0.730741540676746,0.386050283860503,0.558395912268624,0.730741540676746,0.572799097065463,0.642201834862385
Eclipse,svmRadial,bootstrap,balanced,96,9164,4716,4448,3054,1572,1482,Summary,200,1058,195,514,1287,0.844373503591381,0.285397001665741,0.564885252628561,0.844373503591381,0.451172707889126,0.58810450250139
Eclipse,svmRadial,bootstrap,balanced,128,9153,4896,4257,3051,1632,1419,Summary,200,1129,133,503,1286,0.894611727416799,0.281162660704304,0.587887194060551,0.894611727416799,0.467494824016563,0.61408757138972
Eclipse,svmRadial,bootstrap,balanced,160,9748,5014,4734,3249,1671,1578,Summary,200,1166,119,505,1459,0.907392996108949,0.257128309572301,0.582260652840625,0.907392996108949,0.444190476190476,0.596419437340153
Eclipse,svmRadial,bootstrap,balanced,192,9698,5094,4604,3232,1698,1534,Summary,200,1258,71,440,1463,0.946576373212942,0.23121387283237,0.588895123022656,0.946576373212942,0.462330025725836,0.621234567901235
Eclipse,svmRadial,bootstrap,balanced,224,10168,5191,4977,3389,1730,1659,Summary,200,1386,73,344,1586,0.949965729952022,0.178238341968912,0.564102035960467,0.949965729952022,0.466352624495289,0.625592417061611
Eclipse,svmRadial,bootstrap,balanced,256,10238,5250,4988,3411,1749,1662,Summary,200,1403,45,346,1617,0.968922651933702,0.176260825267448,0.572591738600575,0.968922651933702,0.464569536423841,0.628021486123545
Eclipse,svmRadial,bootstrap,balanced,288,10574,5295,5279,3524,1765,1759,Summary,200,1388,23,377,1736,0.983699503897945,0.178419309039281,0.581059406468613,0.983699503897945,0.444302176696543,0.61212789415656
Eclipse,svmRadial,bootstrap,balanced,320,10412,5339,5073,3470,1779,1691,Summary,200,1485,32,294,1659,0.978905735003296,0.150537634408602,0.564721684705949,0.978905735003296,0.472328244274809,0.637202317099335
Eclipse,svmRadial,bootstrap,balanced,352,10608,5388,5220,3536,1796,1740,Summary,200,1552,12,244,1728,0.9923273657289,0.123732251521298,0.558029808625099,0.9923273657289,0.473170731707317,0.640792733278282
Eclipse,svmRadial,bootstrap,balanced,384,10772,5421,5351,3590,1807,1783,Summary,200,1573,16,234,1767,0.989930774071743,0.116941529235382,0.553436151653563,0.989930774071743,0.470958083832335,0.638263339419761
Eclipse,svmRadial,bootstrap,balanced,416,10803,5448,5355,3601,1816,1785,Summary,200,1616,5,200,1780,0.99691548426897,0.101010101010101,0.548962792639535,0.99691548426897,0.47585394581861,0.644209687063982
Eclipse,svmRadial,bootstrap,balanced,448,10833,5478,5355,3611,1826,1785,Summary,200,1665,3,161,1782,0.998201438848921,0.082861554297478,0.5405314965732,0.998201438848921,0.483028720626632,0.651026392961877
Eclipse,svmRadial,bootstrap,balanced,480,10970,5494,5476,3656,1831,1825,Summary,200,1689,10,142,1815,0.994114184814597,0.072560040878896,0.533337112846747,0.994114184814597,0.482020547945205,0.649240822602345
Eclipse,svmRadial,bootstrap,balanced,512,11010,5508,5502,3669,1835,1834,Summary,200,1718,6,117,1828,0.996519721577726,0.060154241645244,0.528336981611485,0.996519721577726,0.48448956570784,0.651992409867173
Eclipse,svmRadial,cv52,balanced,4,5607,2451,3156,1867,816,1051,Summary,200,106,80,710,971,0.56989247311828,0.422367638310529,0.496130055714404,0.56989247311828,0.098421541318477,0.167854315122724
Eclipse,svmRadial,cv52,balanced,8,5607,3000,2607,1867,999,868,Summary,200,756,620,243,248,0.549418604651163,0.494908350305499,0.522163477478331,0.549418604651163,0.752988047808765,0.635294117647059
Eclipse,svmRadial,cv52,balanced,12,5606,3236,2370,1868,1078,790,Summary,200,1015,727,63,63,0.582663605051665,0.5,0.541331802525832,0.582663605051665,0.941558441558442,0.719858156028369
Eclipse,svmRadial,cv52,balanced,16,5606,3465,2141,1868,1155,713,Summary,200,1155,713,0,0,0.61830835117773,NA,NA,0.61830835117773,1,0.764141581210718
Eclipse,svmRadial,cv52,balanced,20,5606,3605,2001,1868,1201,667,Summary,200,1200,666,1,1,0.643086816720257,0.5,0.571543408360129,0.643086816720257,0.999167360532889,0.78252363873492
Eclipse,svmRadial,cv52,balanced,24,7452,3759,3693,2484,1253,1231,Summary,200,686,382,567,849,0.642322097378277,0.400423728813559,0.521372913095918,0.642322097378277,0.446905537459283,0.527084133691894
Eclipse,svmRadial,cv52,balanced,28,7341,3871,3470,2446,1290,1156,Summary,200,823,422,467,734,0.661044176706827,0.388842631140716,0.524943403923772,0.661044176706827,0.528580603725112,0.587437544610992
Eclipse,svmRadial,cv52,balanced,32,7241,3972,3269,2412,1323,1089,Summary,200,902,490,421,599,0.647988505747126,0.412745098039216,0.530366801893171,0.647988505747126,0.60093271152565,0.623574144486692
Eclipse,svmRadial,cv52,balanced,64,7870,4474,3396,2622,1491,1131,Summary,200,1025,354,466,777,0.74329224075417,0.37489943684634,0.559095838800255,0.74329224075417,0.56881243063263,0.644451430367809
Eclipse,svmRadial,cv52,balanced,96,9164,4716,4448,3054,1572,1482,Summary,200,1046,171,526,1311,0.8594905505341,0.286336418072945,0.572913484303523,0.8594905505341,0.443784471786169,0.585338556239508
Eclipse,svmRadial,cv52,balanced,128,9153,4896,4257,3051,1632,1419,Summary,200,1127,186,505,1233,0.858339680121858,0.290563866513234,0.574451773317546,0.858339680121858,0.477542372881356,0.613667301933025
Eclipse,svmRadial,cv52,balanced,160,9748,5014,4734,3249,1671,1578,Summary,200,1182,109,489,1469,0.915569326103795,0.249744637385087,0.582656981744441,0.915569326103795,0.445869483213882,0.599695585996956
Eclipse,svmRadial,cv52,balanced,192,9698,5094,4604,3232,1698,1534,Summary,200,1258,83,440,1451,0.938105891126025,0.232681121099947,0.585393506112986,0.938105891126025,0.46437799926172,0.621234567901235
Eclipse,svmRadial,cv52,balanced,224,10168,5191,4977,3389,1730,1659,Summary,200,1399,72,331,1587,0.95105370496261,0.172575599582899,0.561814652272755,0.95105370496261,0.468519758874749,0.62777653129908
Eclipse,svmRadial,cv52,balanced,256,10238,5250,4988,3411,1749,1662,Summary,200,1397,52,352,1610,0.964113181504486,0.17940876656473,0.571760974034608,0.964113181504486,0.464582640505487,0.627019748653501
Eclipse,svmRadial,cv52,balanced,288,10574,5295,5279,3524,1765,1759,Summary,200,1403,33,362,1726,0.977019498607242,0.173371647509579,0.57519557305841,0.977019498607242,0.44838606583573,0.614676889375685
Eclipse,svmRadial,cv52,balanced,320,10412,5339,5073,3470,1779,1691,Summary,200,1490,33,289,1658,0.97833223900197,0.148433487416538,0.563382863209254,0.97833223900197,0.473316391359593,0.63797901948191
Eclipse,svmRadial,cv52,balanced,352,10608,5388,5220,3536,1796,1740,Summary,200,1538,7,258,1733,0.99546925566343,0.129583124058262,0.562526189860846,0.99546925566343,0.470192601650871,0.638704318936877
Eclipse,svmRadial,cv52,balanced,384,10772,5421,5351,3590,1807,1783,Summary,200,1568,12,239,1771,0.992405063291139,0.118905472636816,0.555655267963978,0.992405063291139,0.469601677148847,0.637527952835942
Eclipse,svmRadial,cv52,balanced,416,10803,5448,5355,3601,1816,1785,Summary,200,1618,9,198,1776,0.994468346650277,0.100303951367781,0.547386149009029,0.994468346650277,0.47672362993518,0.644493128858793
Eclipse,svmRadial,cv52,balanced,448,10833,5478,5355,3611,1826,1785,Summary,200,1663,2,163,1783,0.998798798798799,0.083761562178828,0.541280180488814,0.998798798798799,0.482588508415554,0.650753277245158
Eclipse,svmRadial,cv52,balanced,480,10970,5494,5476,3656,1831,1825,Summary,200,1685,7,146,1818,0.995862884160757,0.074338085539715,0.535100484850236,0.995862884160757,0.481016271767057,0.648700673724735
Eclipse,svmRadial,cv52,balanced,512,11010,5508,5502,3669,1835,1834,Summary,200,1715,8,120,1826,0.995356935577481,0.061664953751285,0.528510944664383,0.995356935577481,0.484326461451567,0.651595744680851
